NO texture/north_texture.xpm
SO      texture/south_texture.xpm
EA texture/east_texture.xpm

F                            20,20,20
C 200,200,200

WE                       texture/west_texture.xpm


1111111
1000001
1011101
101 101
1011101
100N001
1111111