NO texture/north_texture.xpm
SO texture/south_texture.xpm
WE texture/west_texture.xpm
EA texture/east_texture.xpm

F 20,20,20
C 200,200,200

10111
10001
10001
10001
10001
10001
11001
10001
10001
10001
10001
1S001
11111

